smile: ğŸ˜€  
happy: ğŸ˜ƒ  
laugh: ğŸ˜‚  
heart: â¤ï¸  
dog: ğŸ¶  
sun: ğŸŒ  
rocket: ğŸš€  
love: ğŸ˜  
thumbs up: ğŸ‘  
crying: ğŸ˜¢  
sleeping: ğŸ˜´  
angry: ğŸ˜¡  
tree: ğŸŒ²  
volcano: ğŸŒ‹  
party: ğŸ‰  
monkey: ğŸµ  
butterfly: ğŸ¦‹  
spider: ğŸ•·ï¸  
lion: ğŸ¦  
cake: ğŸ°  
moon: ğŸŒ™  
star: â­  
traffic signal: ğŸš¦  
book: ğŸ“š  
writing: ğŸ“  
guitar: ğŸ¸  
car: ğŸš—  
airplane: âœˆï¸  
football: âš½  
mask: ğŸ­  
house: ğŸ¡  
pizza: ğŸ•  
earth: ğŸŒ  
rainbow: ğŸŒˆ  
coffee: â˜•  
fire: ğŸ”¥  
sunflower: ğŸŒ»  
trophy: ğŸ†  
music: ğŸ¶  
alarm clock: â°  
pen: ğŸ–Šï¸  
movie: ğŸ¬  
painting: ğŸ¨  
beach: ğŸ–ï¸  
bicycle: ğŸš²  
basketball: ğŸ€  
apple: ğŸ  
camping: ğŸ•ï¸  
ocean: ğŸŒŠ  
microphone: ğŸ¤  
